######
#X  X#
#    #
#X  X#
######