#######
#     #
#  X  #
# XPX #
#  X  #
#     #
#######
