#######
#     #
#  O  #
# OPO #
#  O  #
#     #
#######
