#######
#  O  #
#  X  #
#OXPXO#
#  X  #
#  O  #
#######