#####
# X #
#XPX#
# X #
#####
